#######===
#     ####
#XCO PP  #
#%###O##O#
#   P  # #  
#B     # #
#    #   #
#   #    # 
#E M#    #
##########